,名前,スコア,
1ST,,800,
2ND,,700,
3RD,,600,
4TH,,500,
5TH,,400,
6TH,,300,
7TH,,200,
8TH,,100,
